44444444444444444444444444444444444444444444444444444444444444444444444444444444444444444444444444444444444444444444444444444444
41113333333333333333333333333333311111111411111111111111111111111111111111111111111111111111111111111111111111133333333333333334
41113333333333333333333333333333111111111411111111111111111111111111111111111111111111111111111111111111111111333333333333333334
41113333333333333333333333333331111111111411111111111111111111111111111111111111111111111111111111111111111111333333333333333334
41113333333333333333333333333311111111111411111111111111111111111111111111111111111111111111111111111111111113333333333333333334
41113333333333333333333333333111111111111411111111111111111111111111111111111111111111111111111111111111111133333333333333333334
41113333333333333333333333331111111111111411111111111111111111111111111111111111111111111111111111111111111333333333333333333334
41111111111111111111133333311111111111111411111111111111111111111111111111111111111111111111111111111111113333333333333333333334
41111111111111111111113333111111111111444444411111111111111111111111111111111111111111111111111111111111133333333333333333333334
42222211111111111111111111111111111111111111111111111111111111111111111111111111111111111111111111111111133333333333333333333334
42222221111111111111111111111111111111111111111111111111111111111111111111111111111111111111111111111111111333333333333333333334
42222222111111111111111111111111111111111111111111111111111111111111111111111111111111111111111111111111111133333333333333333334
42222221211111111111111111111111111111111111111111111111111111111111111111111111111111111111111111111111111111333333333333333334
42222222221111111111111111111111111111111111111111111111111111111111111111111111111111111111111111111111111111133333333333333334
42222222222111111111111111111111111111111111111111111111111111111111111111111111111111111111111111111111111111113333333333333334
42222222222111111111111111111111111111111444444411114444444111111111111111111111111111111111111111111111111111111333333333333334
42222222222111221111111111111111111111111411111111111111114111111111111111111111111111111111111111111111111111111113333333333334
42222222221112122221111111111111111111111411111144441111114111111111111111111111111111111111111111111111111111111111333333333334
42222222222222222221111111111111111111111411111111111111114111111111111111111111111111111111111111111111111111111111111111333334
42222222222222222221111111111111111111111111411133333114111111111111111111111111111111111111111111111111111111111111111111133334
42222222222222222221111111111111111111111111411131513114111111111111111111111111111111111111111111111111111111111111111111113334
42222222222222222211111111111111111111111111411133333114111111111111111111111111111111111111111111111111111111111111111111111134
42222222222222222111111111111111111111111411111111111111114111111111111111111111111111111111111111111111111111111111111111111114
42222222222222221111111111111111111111111411111144444111114111111111111111111111111111111111111111111111111111111111111111111114
41222222222222221111111111111111111111111411111111111111114111111111111111111111111111111111111111111111111111111111111111111114
41122222222222111111111111111111111111111444444411114444444111111111111111111111111111111111111111111111111111111111111111111114
41112222222111111111111111111111111111111111111111111111111111111111111111111111111111111111111111111111111111111111111111111114
41111222222111111111111111111111112221111111111111111111111111111111111111111111111111111111111111111111111111111111111111111114
41111122211111111111111111111111112222111111111222222111111111111111111111111111111111111111111111111111111111111111111111111114
41111111111111111111111111111111121222222222222222222211111111111111111111111111111111111111111111111111111111111111111111111114
41111111111111111111111111111111112222222222222222222221111111111111111111111111111111111111111111111111111111111111111111111114
41111111111111111111111111111111111222222222222222222222111111111111111111111111111111111111111111111111111111111111111111111114
44444444411114444444444411111111111122222222222222222221111111111111111111111111111111111111111111111111111111111111111111111114
41111111111111111111111111111111111112222222222222222211111111111111111111111111111111111111111111111111111111111111111111111114
41111111111111111111111111111111111111222222222222222111111111111111111111111111111111111111111111111111111111111111111111111114
41111111111111111111111111111111111111122222222222221111111111111111111111111111111111111111111111111111111111111111111111111114
41111111111111111111111111111111111111111111111111111111111111111111111111111111111111111111111111111111111111111111111111111114
41111111111111111111111111111111111111111111111111111111111111111111111111111111111111111111111111111111111111111111111111111114
41111111111111111111111111111111111111111111111111111111111111111111111111111111111111111111111111111111111111111111111111111114
41111111111111111111111111111111111111111111111111111111111111111111111111111111111111111111111111111111111111111111111111111114
41111111111111111111111111111111111111111111111111111111111111111111111111111111111111111111111111111111111111111111111111111114
41111111111111111111111111111111111111111111111111111111111111111111111111111111111111111111111111111111111111111111111111111114
41111111111111111111111111111111111111111111111111111111111111111111111111111111111111111111111111111111111111111111111111111114
41111111111111111111111111111111111111111111111111111111111111111111111111111111111111111111111111111111111111111111111111111114
41111111111111111111111111111111111111111111111111111111111111111111111111111111111111111111111111111111111111111111111111111114
41111111111111111111111111111111111111111111111111111111111111111111111111111111111111111111111111111111111111111111111111111114
41111111111111111111111111111111111111111111111111111111111111111111111111111111111111111111111111111111111111111111111111111114
41111111111111111111111111111111111111111111111111111111111111111111111111111111111111111111111111111111111111111111111111111114
41111111111111111111111111111111111111111111111111111111111111111111111111111111111111111111111111111111111111111111111111111114
41111111111111111111111111111111111111111111111111111111111111111111111111111111111111111111111111111111111111111111111111111114
41111111111111111111111111111111111111111111111111111111111111111111111111111111111111111111111111111111111111111111111111111114
41111111111111111111111111111111111111111111111111111111111111111111111111111111111111111111111111111111111111111111111111111114
41111111111111111111111111111111111111111111111111111111111111111111111111111111111111111111111111111111111111111111111111111114
41111111111111111111111111111111111111111111111111111111111111111111111111111111111111111111111111111111111111111111111111111114
41111111111111111111111111111111111111111111111111111111111111111111111111111111111111111111111111111111111111111111111111111114
41111111111111111111111111111111111111111111111111111111111111111111111111111111111111111111111111111111111111111111111111111114
41111111111111111111111111111111111111111111111111111111111111111111111111111111111111111111111111111111111111111111111111111114
41111111111111111111111111111111111111111111111111111111111111111111111111111111111111111111111111111111111111111111111111111114
41111111111111111111111111111111111111111111111111111111111111111111111111111111111111111111111111111111111111111111111111111114
41111111111111111111111111111111111111111111111111111111111111111111111111111111111111111111111111111111111111111111111111111114
41111111111111111111111111111111111111111111111111111111111111111111111111111111111111111111111111111111111111111111111111111114
41111111111111111111111111111111111111111111111111111111111111111111111111111111111111111111111111111111111111111111111111111114
41111111111111111111111111111111111111111111111111111111111111111111111111111111111111111111111111111111111111111111111111111114
41111111111111111111111111111111111111111111111111111111111111111111111111111111111111111111111111111111111111111111111111111114
41111111111111111111111111111111111111111111111111111111111111111111111111111111111111111111111111111111111111111111111111111114
41111111111111111111111111111111111111111111111111111111111111111111111111111111111111111111111111111111111111111111111111111114
41111111111111111111111111111111111111111111111111111111111111111111111111111111111111111111111111111111111111111111111111111114
41111111111111111111111111111111111111111111111111111111111111111111111111111111111111111111111111111111111111111111111111111114
41111111111111111111111111111111111111111111111111111111111111111111111111111111111111111111111111111111111111111111111111111114
41111111111111111111111111111111111111111111111111111111111111111111111111111111111111111111111111111111111111111111111111111114
41111111111111111111111111111111111111111111111111111111111111111111111111111111111111111111111111111111111111111111111111111114
41111111111111111111111111111111111111111111111111111111111111111111111111111111111111111111111111111111111111111111111111111114
41111111111111111111111111111111111111111111111111111111111111111111111111111111111111111111111111111111111111111111111111111114
41111111111111111111111111111111111111111111111111111111111111111111111111111111111111111111111111111111111111111111111111111114
41111111111111111111111111111111111111111111111111111111111111111111111111111111111111111111111111111111111111111111111111111114
41111111111111111111111111111111111111111111111111111111111111111111111111111111111111111111111111111111111111111111111111111114
41111111111111111111111111111111111111111111111111111111111111111111111111111111111111111111111111111111111111111111111111111114
41111111111111111111111111111111111111111111111111111111111111111111111111111111111111111111111111111111111111111111111111111114
41111111111111111111111111111111111111111111111111111111111111111111111111111111111111111111111111111111111111111111111111111114
41111111111111111111111111111111111111111111111111111111111111111111111111111111111111111111111111111111111111111111111111111114
41111111111111111111111111111111111111111111111111111111111111111111111111111111111111111111111111111111111111111111111111111114
41111111111111111111111111111111111111111111111111111111111111111111111111111111111111111111111111111111111111111111111111111114
41111111111111111111111111111111111111111111111111111111111111111111111111111111111111111111111111111111111111111111111111111114
41111111111111111111111111111111111111111111111111111111111111111111111111111111111111111111111111111111111111111111111111111114
41111111111111111111111111111111111111111111111111111111111111111111111111111111111111111111111111111111111111111111111111111114
41111111111111111111111111111111111111111111111111111111111111111111111111111111111111111111111111111111111111111111111111111114
41111111111111111111111111111111111111111111111111111111111111111111111111111111111111111111111111111111111111111111111111111114
41111111111111111111111111111111111111111111111111111111111111111111111111111111111111111111111111111111111111111111111111111114
41111111111111111111111111111111111111111111111111111111111111111111111111111111111111111111111111111111111111111111111111111114
41111111111111111111111111111111111111111111111111111111111111111111111111111111111111111111111111111111111111111111111111111114
41111111111111111111111111111111111111111111111111111111111111111111111111111111111111111111111111111111111111111111111111111114
41111111111111111111111111111111111111111111111111111111111111111111111111111111111111111111111111111111111111111111111111111114
41111111111111111111111111111111111111111111111111111111111111111111111111111111111111111111111111111111111111111111111111111114
41111111111111111111111111111111111111111111111111111111111111111111111111111111111111111111111111111111111111111111111111111114
41111111111111111111111111111111111111111111111111111111111111111111111111111111111111111111111111111111111111111111111111111114
41111111111111111111111111111111111111111111111111111111111111111111111111111111111111111111111111111111111111111111111111111114
41111111111111111111111111111111111111111111111111111111111111111111111111111111111111111111111111111111111111111111111111111114
41111111111111111111111111111111111111111111111111111111111111111111111111111111111111111111111111111111111111111111111111111114
41111111111111111111111111111111111111111111111111111111111111111111111111111111111111111111111111111111111111111111111111111114
41111111111111111111111111111111111111111111111111111111111111111111111111111111111111111111111111111111111111111111111111111114
41111111111111111111111111111111111111111111111111111111111111111111111111111111111111111111111111111111111111111111111111111114
41111111111111111111111111111111111111111111111111111111111111111111111111111111111111111111111111111111111111111111111111111114
41111111111111111111111111111111111111111111111111111111111111111111111111111111111111111111111111111111111111111111111111111114
41111111111111111111111111111111111111111111111111111111111111111111111111111111111111111111111111111111111111111111111111111114
41111111111111111111111111111111111111111111111111111111111111111111111111111111111111111111111111111111111111111111111111111114
41111111111111111111111111111111111111111111111111111111111111111111111111111111111111111111111111111111111111111111111111111114
41111111111111111111111111111111111111111111111111111111111111111111111111111111111111111111111111111111111111111111111111111114
41111111111111111111111111111111111111111111111111111111111111111111111111111111111111111111111111111111111111111111111111111114
41111111111111111111111111111111111111111111111111111111111111111111111111111111111111111111111111111111111111111111111111111114
41111111111111111111111111111111111111111111111111111111111111111111111111111111111111111111111111111111111111111111111111111114
41111111111111111111111111111111111111111111111111111111111111111111111111111111111111111111111111111111111111111111111111111114
41111111111111111111111111111111111111111111111111111111111111111111111111111111111111111111111111111111111111111111111111111114
41111111111111111111111111111111111111111111111111111111111111111111111111111111111111111111111111111111111111111111111111111114
41111111111111111111111111111111111111111111111111111111111111111111111111111111111111111111111111111111111111111111111111111114
41111111111111111111111111111111111111111111111111111111111111111111111111111111111111111111111111111111111111111111111111111114
41111111111111111111111111111111111111111111111111111111111111111111111111111111111111111111111111111111111111111111111111111114
41111111111111111111111111111111111111111111111111111111111111111111111111111111111111111111111111111111111111111111111111111114
41111111111111111111111111111111111111111111111111111111111111111111111111111111111111111111111111111111111111111111111111111114
41111111111111111111111111111111111111111111111111111111111111111111111111111111111111111111111111111111111111111111111111111114
41111111111111111111111111111111111111111111111111111111111111111111111111111111111111111111111111111111111111111111111111111114
41111111111111111111111111111111111111111111111111111111111111111111111111111111111111111111111111111111111111111111111111111114
41111111111111111111111111111111111111111111111111111111111111111111111111111111111111111111111111111111111111111111111111111114
41111111111111111111111111111111111111111111111111111111111111111111111111111111111111111111111111111111111111111111111111111114
41111111111111111111111111111111111111111111111111111111111111111111111111111111111111111111111111111111111111111111111111111114
41111111111111111111111111111111111111111111111111111111111111111111111111111111111111111111111111111111111111111111111111111114
41111111111111111111111111111111111111111111111111111111111111111111111111111111111111111111111111111111111111111111111111111114
41111111111111111111111111111111111111111111111111111111111111111111111111111111111111111111111111111111111111111111111111111114
44444444444444444444444444444444444444444444444444444444444444444444444444444444444444444444444444444444444444444444444444444444
