0 1 2 2 3
0 1 4 3 2
0 0 0 0 1
0 2 0 0 0
4 0 0 5 0

